$ANSIBLE_VAULT;1.2;AES256;ssh
36353862343462653132386234636630343332376432343238616231633135376263623662613336
3862363366616635636265333064333566653762343866300a653932393938643432313435383031
34333236393665633138656631636533356433623665346632636130336363343639663765396536
3462313132386464300a666136323331666561386435353863353864363232643434646236633965
31623465303631313064343966343638333731393830306165356634373336613261363330623537
63623038313464633035393938316161353263313337393162373638386636653138616465356435
35663631303330353539633565666365353534376164653334643866383561333039316633363062
31303865356237663462326134373362633035393862633565613833393061623363363231373837
65316630386531356635643665613431643530626666363833323863343138396239643238633662
35626262313462343662363466663334316331626166653561653132646630396563326330336465
63323836323433643932396563623064653034376132326461353165373333366430383865356430
63666364353166306639363734313465663561326461613930303735356466383331316130373062
34656438353835393666303463373361626664656661666231393966353332323163303739316131
65366138633437363661363064633062613164646561616231336138373566306565306230303963
38626263383066343837326133366565643964396463383333646338646462376437376231646163
37356336386565363661373030613634323564336364383737306437633130366166353639333665
33633333623131623066643531626462663032633562313764326637663064323463363937303838
39393262346539376664363462353033323366353536653530306338343831373639366331343538
66366562346139386262623036353862353462356439363363303938376139356531353863346332
34353164333032626566393563643835343936623266643963333236353131643061373237633832
30313435613832326334666161613939373537326230366365363431663532323935373966316135
37336663623232366433613565653163313531656265373935323964303039663737343861396165
32343266396331386463616630623463633766303261383865666133623364373535353932333939
38363561643237636362333764663435653939383331376262386135613630373936323264336338
36353834653532613939303563303536653161613635303538373833653564393561376561666331
34356134616139303034613961306633393632666565366231393530343931646561306264653936
66396163386634306535613163663133646664373631633864623366646464373934363436363932
39353431383230373230
